{
    "background1" : [
		[  1,  1,  1,  1,  6,  1,  1,  1,  1,  1,  1,  1,  6,  1,  1,  1,  1,  1,  1,  1,  1,  1,  1,  1],
		[  1,  1,  1,  1,  6,  1,  1,  1,  1,  1,  1,  1,  6,  1,  1,  1,  1,  1,  1,  1,  1,  1,  1,  1],
		[  1,  1,  1,  1,  6,  1,  1,  1,  1,  1,  1,  1,  6,  1,  1,  1,  1,  1, 24,  1,  1,  1,  1,  1],
		[  1,  1,  1,  1,  6,  1,  1,  1,  1,  1,  1,  1,  6,  1,  1,  1,  1,  1,  1,  1,  1,  1,  1,  1],
		[  1,  1,  1,  1,  6,  1,  1,  1,  1,  1,  1,  1,  6,  1,  1,  1,  1,  1,  1,  1,  1,  1, 24,  1],
		[  1,  1,  1,  1,  6,  1, 24,  1,  1,  1,  1, 23,  6,  1,  1,  1,  1,  1,  1,  1,  1,  1,  1,  1],
		[ 13,  5,  5,  5,  2,  5,  5,  5,  5,  5,  5,  5, 11,  5,  5,  5,  5,  5, 12,  5,  5,  5,  5,  5],
		[  1,  1,  1,  1,  6,  1,  1,  1,  1,  1,  1,  1,  1,  1,  1,  1,  1,  1,  6,  1,  1,  1,  1,  1],
		[  1,  1,  1,  1,  6,  1,  1,  1,  1,  1,  1,  1,  1,  1,  1,  1,  1,  1,  6,  1,  1,  1,  1,  1],
		[  1,  1,  1,  1,  6,  1,  1,  1,  1,  1,  1,  1,  1,  1,  1,  1,  1,  1,  6,  1,  1,  1,  1,  1],
		[  1,  1,  1,  1,  6,  1,  1,  1,  1,  1,  1,  1,  1, 19,  1,  1,  1,  1, 16,  1,  1,  1,  1,  1],
		[  1,  1,  1,  1,  6,  1,  1,  1,  1,  1,  1,  1,  1,  1,  1,  1,  1,  1,  1,  1,  1,  1,  1,  1]
	],	
	
	"carte1" : [
		[ 20, 20, 20, 20, 20, 20, 20, 20, 20, 20, 20, 20, 20, 20, 20, 20, 20, 20, 20, 20, 20, 25, 26, 20],
		[ 20, 25, 26, 20, 20, 20, 20, 20, 20, 20, 20, 20, 20, 25, 26, 20, 20, 20, 20, 20, 20, 29, 30, 20],
		[ 20, 29, 30, 20, 20, 20, 25, 26, 20, 20, 20, 20, 20, 29, 30, 20, 20, 20, 20, 20, 20, 20, 20, 20],
		[ 20, 20, 20, 20, 20, 20, 29, 30, 20, 17, 18, 20, 20, 20, 20, 20, 20, 20, 20, 20, 25, 26, 20, 20],
		[ 20, 17, 18, 20, 20, 20, 20, 20, 20, 21, 22, 20, 20, 20, 25, 26, 20, 20, 20, 20, 29, 30, 20, 20],
		[ 20, 21, 22, 20, 20, 20, 20, 20, 20, 20, 20, 20, 20, 20, 29, 30, 20, 20, 20, 20, 20, 20, 20, 20],
		[ 20, 20, 20, 20, 20, 20, 20, 20, 20, 20, 20, 20, 20, 20, 20, 20, 20, 20, 20, 20, 20, 20, 20, 20],
		[ 20, 20, 20, 20, 20, 20, 20, 25, 26, 20, 20, 20, 20, 20, 20, 20, 20, 20, 20, 20, 20, 20, 20, 20],
		[ 20, 25, 26, 20, 20, 20, 20, 29, 30, 20, 20, 20, 20, 20, 20, 17, 18, 20, 20, 20, 20, 20, 20, 20],
		[ 20, 29, 30, 20, 20, 20, 20, 20, 20, 20, 20, 20, 20, 20, 20, 21, 22, 20, 20, 20, 17, 18, 20, 20],
		[ 20, 20, 20, 20, 20, 17, 18, 20, 20, 20, 20, 20, 20, 20, 20, 20, 20, 20, 20, 20, 21, 22, 20, 20],
		[ 20, 20, 20, 20, 20, 21, 22, 20, 20, 20, 20, 20, 20, 20, 20, 20, 20, 20, 20, 20, 20, 20, 20, 20]
	],

    "background2" : [
		[ 1,  1,  1,  1,  6,  1,  1,  1,  1,  1,  1,  1,  1,  1,  1,  6,  1,  1,  1,  1,  1,  1,  1,  1],
		[ 1,  1,  1,  1,  6,  1,  1,  1,  1, 24,  1,  1,  1,  1,  1,  6,  1,  1,  1,  1,  1,  1,  1,  1],
		[ 1,  1,  1,  1,  6,  1,  1,  1,  1,  1,  1,  1,  1,  1,  1,  8,  5,  5,  4,  1,  1,  1,  1,  1],
		[19,  1,  1,  1,  6,  1,  1,  1,  1,  1,  1,  1, 23,  1,  1,  1,  1,  1,  6,  1,  1,  1,  1,  1],
		[ 1,  1,  1,  1,  6,  1,  1,  1,  1,  1,  1,  1,  1,  1,  1,  1,  1,  1,  6,  1,  1,  1,  1,  1],
		[ 1, 19,  1,  1,  6,  1,  1,  1,  1, 19,  1,  1,  1,  1,  1,  1,  1,  1,  6,  1,  1,  1,  1,  1],
		[ 5,  5,  5,  5,  2,  5,  5,  5,  5,  5,  5, 12,  5,  5,  5,  5,  5,  5, 11,  5,  5,  5,  5,  5],
		[ 1,  1,  1,  1,  6,  1,  1,  1,  1,  1,  1,  6,  1,  1,  1,  1,  1,  1,  1,  1,  1,  1,  1,  1],
		[ 1,  1,  1,  1,  6,  1,  1,  1,  1,  1,  1,  6,  1,  1,  1, 51, 36, 36, 36, 36, 52,  1,  1,  1],
		[ 1,  1,  1,  1,  6,  1,  1,  1,  1,  1,  1,  6,  1,  1,  1, 49, 44, 44, 44, 44, 50,  1, 24,  1],
		[ 1,  1,  1,  1,  6,  1,  1,  1, 13,  5,  5,  7,  1,  1,  1, 45, 46, 46, 46, 46, 47,  1,  1,  1],
		[ 1,  1,  1,  1,  6,  1,  1,  1,  1,  1,  1,  1,  1,  1,  1,  1,  1,  1,  1,  1,  1,  1,  1,  1]
	],
	
	"carte2" : [
		[ 20, 20, 20, 20, 20, 20, 20, 20, 20, 20, 20, 20, 20, 20, 20, 20, 20, 20, 20, 20, 20, 25, 26, 20],
		[ 17, 18, 20, 20, 20, 20, 20, 20, 20, 20, 20, 20, 17, 18, 20, 20, 20, 20, 20, 20, 20, 29, 30, 20],
		[ 21, 22, 20, 20, 20, 20, 25, 26, 20, 20, 20, 20, 21, 22, 20, 20, 20, 20, 20, 20, 20, 20, 20, 20],
		[ 20, 20, 20, 20, 20, 20, 29, 30, 20, 17, 18, 20, 20, 20, 20, 20, 20, 20, 20, 20, 25, 26, 20, 20],
		[ 20, 20, 17, 18, 20, 20, 20, 20, 20, 21, 22, 20, 20, 20, 25, 26, 20, 20, 20, 20, 29, 30, 20, 20],
		[ 20, 20, 21, 22, 20, 20, 20, 20, 20, 20, 20, 20, 20, 20, 29, 30, 20, 20, 20, 20, 20, 20, 20, 20],
		[ 20, 20, 20, 20, 20, 20, 20, 20, 20, 20, 20, 20, 20, 20, 20, 20, 20, 20, 20, 20, 20, 20, 20, 20],
		[ 20, 20, 20, 20, 20, 20, 20, 25, 26, 20, 20, 20, 20, 20, 20, 20, 33, 34, 35, 20, 20, 20, 20, 20],
		[ 20, 25, 26, 20, 20, 20, 20, 29, 30, 20, 20, 20, 20, 20, 20, 20, 37, 38, 39, 40, 20, 20, 20, 20],
		[ 20, 29, 30, 20, 20, 17, 18, 20, 20, 20, 20, 20, 20, 20, 20, 20, 20, 20, 20, 20, 20, 20, 20, 20],
		[ 20, 20, 20, 20, 20, 21, 22, 20, 20, 20, 20, 20, 20, 20, 20, 20, 20, 20, 20, 20, 20, 20, 20, 20],
		[ 20, 20, 20, 20, 20, 20, 20, 20, 20, 20, 20, 20, 20, 20, 20, 20, 20, 20, 20, 20, 20, 20, 20, 20]
	]	
}
