{
    "carte1" : [
		[ 1,  1,  1,  1,  1,  1,  1,  1,  1,  1,  1,  1,  1,  1,  1,  1,  1,  1,  1,  1,  1,  1,  1,  1],
		[ 2,  2,  2,  2,  2,  2, 14,  2,  2,  2,  2,  2, 14,  2,  2,  2,  2,  2,  2,  2,  2,  2,  2,  2],
		[ 1,  1,  1,  1,  1,  4,  4,  4,  4,  1,  1,  1, 10,  1,  1,  1,  1,  1,  1,  1,  1,  1,  1,  1],
		[ 1,  4,  1,  1,  1,  1,  1,  3,  4,  1,  1,  1, 10,  1,  1,  1,  1, 11, 12,  1,  1,  1,  1,  1],
		[ 1,  1,  1,  3,  1,  4,  4,  4,  4,  1,  1,  1, 10,  1,  1,  1,  1, 15, 16,  1,  1,  1,  1,  1],
		[ 1,  1,  1,  1,  1,  1,  1,  1,  1,  1,  1,  1, 10,  1,  1,  1,  1,  1,  1,  1,  1,  1,  1,  1],
		[ 1,  1,  1,  1,  1,  1,  1,  1,  1,  1,  1,  1, 10,  1,  1,  1,  1,  1,  1,  1,  1,  1,  1,  1],
		[ 1,  1,  1,  1,  1,  1,  1,  1,  1,  1,  1,  1, 13,  2,  2,  6,  1,  1,  1,  7,  1,  1,  1,  1],
		[ 1,  1,  1,  1,  1,  1,  1,  1,  1,  1,  1,  1,  1,  1,  1, 10,  1,  1,  1,  1,  1,  1,  1,  1],
		[ 1,  1,  1,  1,  1,  4,  1,  1,  1,  1,  1,  1,  1,  8,  1, 10,  1,  1,  1,  1,  1,  1,  1,  1],
		[ 1,  1,  1,  1,  1,  1,  1,  1,  1,  1,  1,  1,  1,  1,  1, 10,  1,  1,  1,  1,  1,  1,  1,  1],
		[ 1,  1,  1,  1,  1,  1,  1,  1,  1,  1,  1,  1,  1,  1,  1, 10,  1,  1,  1,  1,  1,  1,  1,  1]
	],	

    "carte2" : [
		[ 1,  1,  1,  1,  1,  1,  1,  1,  1,  1,  1,  1,  1, 10,  1,  1,  1,  1,  1,  1,  1,  1,  1,  1],
		[ 2,  2,  2,  2,  2,  6,  1,  1, 11, 12,  1,  1,  1, 10,  1,  1,  1,  1,  1,  1,  1, 28,  2,  2],
		[ 1,  1,  1,  1,  1, 10,  1,  1, 15, 16,  1,  1,  1, 10,  1,  1,  1,  1,  1,  1,  1, 10,  1,  1],
		[ 1,  1,  1,  1,  1, 10,  1,  1,  1,  1,  1,  1,  1, 10,  1,  1,  1,  1,  1,  1,  1, 10,  1,  1],
		[ 1,  1,  1,  1,  1, 10,  1,  1,  1,  1,  8,  1,  1, 10,  1,  1,  1,  1,  1,  1,  1, 10,  1,  1],
		[ 1,  1,  1,  1,  1, 13,  2,  2,  2,  2,  2,  2,  2,  9,  2,  2,  2,  2,  2,  2,  2, 27,  1,  1],
		[ 1,  1,  1,  1,  1,  1,  1,  1,  1,  1,  1,  1,  1, 10,  1,  1,  1,  1,  1,  1, 17,  1,  1,  1],
		[ 1, 19, 20,  1,  1,  1,  1,  1,  1,  1,  1,  1,  1, 10,  1,  1,  1, 19, 20,  1,  1,  1,  1,  1],
		[ 1, 23, 24,  1,  1,  1,  1,  1,  4,  1,  1,  1,  1, 10,  1,  1,  1, 23, 24,  1,  1,  1,  1,  1],
		[ 1,  1,  1,  1, 17,  1,  1,  1,  1,  1,  1,  1,  1, 10,  1, 21,  1,  1,  1,  1,  1,  1,  1,  1],
		[ 1,  1,  1,  1,  1,  1,  1,  1,  1,  1,  1,  1,  1, 10,  1,  1,  1,  1,  1, 21,  1,  1,  1,  1],
		[ 1,  1,  1,  1,  1,  1,  1,  1,  1,  1,  1,  1,  1, 10,  1,  1,  1,  1,  1,  1,  1,  1,  1,  1]
	]	
}
