{
    "tileset" : "tileset-petit.png",
    "terrain" : [
	[ 1,  1,  1,  1,  6,  1,  1,  1,  1,  1,  1,  1],
	[ 1,  3,  4,  1,  6,  1,  1,  1,  1,  1,  1,  1],
	[ 1,  7,  8,  1,  6,  1,  1,  1,  1,  1,  1,  1],
	[ 1,  1,  1,  1,  6,  1,  1,  1,  1,  3,  4,  1],
	[ 1,  1,  1,  1,  6,  1,  1,  1,  1,  7,  8,  1],
	[ 1,  1,  1,  1,  6,  1,  1,  1,  1,  1,  1,  1],
	[ 5,  5,  5,  5,  2,  5,  5,  5,  5,  5,  5,  5],
	[ 1,  1,  1,  1,  6,  1,  1,  1,  1,  1,  1,  1],
	[ 1,  1,  1,  1,  6,  1,  1,  1,  1,  1,  1,  1],
	[ 1,  1,  1,  1,  6,  1,  1,  1,  1,  1,  1,  1],
	[ 1,  1,  1,  1,  6,  3,  4,  1,  1,  1,  1,  1],
	[ 1,  1,  1,  1,  6,  7,  8,  1,  1,  1,  1,  1]
    ]
}
